%%%%%%%%%%%%%%%%%%%%
%                  %
%%%%%%%%%%%%%%%%   %
%    G       G     % 
%  %%%%%%%%%%%%%%%%%
%          GG      %
% %%%%%%%%%%%%%%%%%%
%                  %
%%% %%%%%%%%%%%%   %
%      P           %
%  %%%%%%%%%%%%%%%%%
%                  %
%        %%%%%%    %
%%%%%%%%%%%%%%%%%%%%
